16 29
###                 #########
#   ######B############   # #
# ####                # # # #
# ################### # # # #
#                     # # # #
##################### # # # #
#   ##                # # # #
# # ## ### ## ######### # # #
# #           #         # # #
# # ## ################ # # #
### ##             #### # # #
### ############## ## # # # #
###          ##       # # # #
###### ######## ####### # # #
##########              #   #
A          ##################